Playground
An Interactive Fiction by Chris McLean-Wheeler and Jonathan Wheeler
Release 1 / Serial number 171114 / Inform 7 build 6M62 (I6/v6.33 lib 6/12N) SD

Red Room
There are exits to the north and west., and a door to the south.

You can see the wooden door here.

>die
That's not a verb I recognise.

>eat
(the wooden door)
That's plainly inedible.

>s
(first opening the wooden door)

Violet Room
There are exits to the south and west, and a door to the north.

You can see a wooden door and Mr Fruit (on which is a pear) here.

>w
Orange Room
There are exits to the east and south.

>take orange
That's hardly portable.

>i
You are carrying nothing.

>look at room
You can't see any such thing.

>take orang
You can't see any such thing.

>take orange
That's hardly portable.

>look in orang
You can't see any such thing.

>l
Orange Room
There are exits to the east and south.

>look at orange room
You can't see any such thing.

>look orange room
I only understood you as far as wanting to look the orange wall.

>look orange wall
The orange wall is empty.

>restart
Are you sure you want to restart?

>y
Playground
An Interactive Fiction by Chris McLean-Wheeler
Release 1 / Serial number 171114 / Inform 7 build 6M62 (I6/v6.33 lib 6/12N) SD

Red Room
There are exits to the north and west., and a door to the south.

You can see a wooden door here.

>s
(first opening the wooden door)

Violet Room
There are exits to the south and west, and a door to the north.

You can see a wooden door and Mr Fruit (on which is a pear) here.

* * *

>w
Orange Room
There are exits to the east and south.

>look at orang
You can't see any such thing.

>look at orange wall
The orange wall is empty.

* * *

Playground
An Interactive Fiction by Chris McLean-Wheeler and Jonathan Wheeler
Release 1 / Serial number 171114 / Inform 7 build 6M62 (I6/v6.33 lib 6/12N) SD

Red Room
There are exits to the north and west., and a door to the south.

You can see the wooden door here.

>w
Blue Room
There are exits to the north and east.

You can see Mr Fruit here.

>e
Red Room
You can see a wooden door here.

>s
(first opening the wooden door)

Violet Room
There are exits to the south and west, and a door to the north.

You can see a wooden door and Mr Fruit (on which is a pear) here.

* * *

>w
Orange Room
There are exits to the east and south.

>look at orange wall
You can't see any such thing.

>look at orwall
The orange wall is empty.

* * *

>w
Blue Room
There are exits to the north and east.

You can see Mr Fruit here.

>n
Green Room
There are exits to the east and south.

In this room is a medium-sized cardboard box.

>take box
The box's bottom gives, and its contents spill onto the ground.

[Your score has just gone up by five points.]

>take apple
[Your score has just gone up by one point.]

>drop apple
Dropped.

>take apple
[Your score has just gone up by one point.]

>put apple in box
It drops through the bottom of the box and onto the floor.

>take apple
[Your score has just gone up by one point.]

* * *

>put apple in box
It drops through the bottom of the box and onto the floor.

>z
Time passes.

>z
Time passes.

>restart
Are you sure you want to restart?

>y
Playground
An Interactive Fiction by Chris McLean-Wheeler
Release 1 / Serial number 171114 / Inform 7 build 6M62 (I6/v6.33 lib 6/12N) SD

Red Room
There are exits to the north and west., and a door to the south.

You can see the wooden door here.

>n
Yellow Room
There are exits to the west and south.

>w
Green Room
There are exits to the east and south.

In this room is a medium-sized cardboard box.

>take apple
[Your score has just gone up by one point.]

>put apple in box
[Your score has just gone up by five points.]

>take box
The box's bottom gives, and its contents spill onto the ground.

[Your score has just gone up by five points.]

* * *

>put apple in box
It drops through the bottom of the box and onto the floor.

>put apple in box
It drops through the bottom of the box and onto the floor.

>drop box
[Your score has just gone down by five points.]

>take apple
[Your score has just gone up by one point.]

* * *

>take box
The box's bottom gives, and its contents spill onto the ground.

[Your score has just gone up by five points.]

>drop box
[Your score has just gone down by five points.]

* * *

>w
Blue Room
There are exits to the north and east.

You can see Mr Fruit here.

>take jar
Mr Fruit pulls it out of your reach, wags a finger at you, and says "Rude!"

>ask mr fruit for jar
Mr Fruit smiles and hands you the jar of grapes.

>ask mr fruit for grapes
Mr Fruit extends his empty palms to you and shrugs.

>n
Green Room
There are exits to the east and south.

In this room is a medium-sized cardboard box.

>drop jar
Dropped.

>take jar
Taken.

>drop jar
Dropped.

>take box
The box's bottom gives, and its contents spill onto the ground.

>s
Blue Room
You can see Mr Fruit here.

>e
Red Room
You can see the wooden door here.

>drop box
Dropped.

* * *

>s
(first opening the wooden door)

Orange Room.
There are exits to the east and south, and a door to the north.

You can see the wooden door here.

>i
You are carrying:
  a box

>w
You can't go that way.

>s
Grey Room
There are exits to the north, south, and to the west a void.

There is a void to the west of this room, across which you can see a Green Room.

>drop box
Dropped.

>s
Brown Room
There are exits to the north and east.

You can see a watermelon and a cherry here.

>take cherry
The cherry is light!

>n
Grey Room
There is a void to the west of this room, across which you can see a Green Room.

You can also see a box (empty) here.

>n
Orange Room.
You can see the wooden door here.

>e
Violet Room
There are exits to the south and west.

You can see Mr Fruit (on which is a pear) here.

>s
Black Room
You now see that the this room wasn't actually dark, but simply so black that you couldn't see the exits. These are to the north and east.

>e
Pink Room
There is an exit to the west.

You can see a tiny room here.

>take room
Taken.

>w
Black Room

>n
Violet Room
You can see Mr Fruit (on which is a pear) here.

>w
Orange Room.
You can see the wooden door here.

>s
Grey Room
There is a void to the west of this room, across which you can see a Green Room.

You can also see a box (empty) here.

>put box in void
What would that accomplish?

>w
You cannot traverse the void.

>put room in void
The miniature room is tugged into the void by an unseen force. As it enters the void, it expands until it is normal room size, with entrances that perfectly align with the rooms on either side.

>w
Magenta Room
There are exits to the west and east.

>w
Beige Room
There is an exit to the east.

You can see a roll of scotch tape here.

>take tape
Taken.

>e
Magenta Room

I beg your pardon?

>e
Grey Room
You can see a box (empty) here.

>tape box
Now the box should withstand the weight of other objects inside it.

>drop tape
Dropped.

* * *

>s
Brown Room
You can see a watermelon here.

>take cherry
You already have that.

>take watermelon
You're carrying too many things already.

>put cherry in box
You put the cherry into the box.

>put melon in box
You can't see any such thing.

>put watermelon in box
(first taking the watermelon)
The melon is extremely heavy!

You put the watermelon into the box.

>i
You are carrying:
  a box
    a watermelon
    a cherry

>n
Grey Room
You can see a roll of scotch tape here.

>s
Brown Room

>e
White Room
There is an exit to the west.

Here is a wacky banana car, powered by unknown technology. It has a steering column and a gas (?) pedal.

>get in car
You get into the the banana car.

"Banana banana!"

>w
Brown Room (in the the banana car)
"Banana banana!"

>n
Grey Room (in the the banana car)
You can see a roll of scotch tape here.

"Banana banana!"

>n
Orange Room. (in the the banana car)
You can see the wooden door here.

"Banana banana!"

>e
Violet Room (in the the banana car)
You can see Mr Fruit (on which is a pear) here.

"Banana banana!"

>w
Orange Room. (in the the banana car)
You can see the wooden door here.

"Banana banana!"

>n
Red Room (in the the banana car)
You can see the wooden door here.

"Banana banana!"

>w
Blue Room (in the the banana car)
You can see Mr Fruit here.

Mr Fruit says "That is one fine banana car, my dude."

>n
Green Room (in the the banana car)
You can see an apple and a jar (in which are some grapes) here.

"Banana banana!"

>e
Yellow Room (in the the banana car)
There are exits to the west and south.

As you enter this room, the banana car is overwhelmed by the yellowness of its walls and floor. You are thrown from the car, and before your very eyes the car begins to transform into something else...something greater.

Yellow Room
There are exits to the west and south.

You can see a the banana car (empty) here.

>l
Yellow Room
There are exits to the west and south.

You can see a banana here.

>take banana
Taken.

>put banana in box
You put the banana into the box.

>i
You are carrying:
  a box
    a banana
    a watermelon
    a cherry

>w
Green Room
You can see an apple and a jar (in which are some grapes) here.

>put apple in box
(first taking the apple)
You put the apple into the box.

>take grapes
Taken.

>i
You are carrying:
  some grapes
  a box
    an apple
    a banana
    a watermelon
    a cherry

>put grapes in box
You put the grapes into the box.

>e
Yellow Room

>s
Red Room
You can see the wooden door here.

>s
Orange Room.
You can see the wooden door here.

>i
You are carrying:
  a box
    some grapes
    an apple
    a banana
    a watermelon
    a cherry

>l
Orange Room.
There are exits to the east and south, and a door to the north.

You can see the wooden door here.

>look at mr fruit
You can't see any such thing.

>w
You can't go that way.

>e
Violet Room
You can see Mr Fruit (on which is a pear) here.

>take pear
Taken.

>s
Black Room

>n
Violet Room
You can see Mr Fruit here.

>put pear in box
You put the pear into the box.

>i
You are carrying:
  a box
    a pear
    some grapes
    an apple
    a banana
    a watermelon
    a cherry

>w
Orange Room.
You can see the wooden door here.

>look at wall
In the wall is an orange.

>take orange
Taken.

>put orange in box
You put the orange into the box.

>i
You are carrying:
  a box
    an orange
    a pear
    some grapes
    an apple
    a banana
    a watermelon
    a cherry

* * *

Playground
An Interactive Fiction by Chris McLean-Wheeler and Jonathan Wheeler
Release 1 / Serial number 171114 / Inform 7 build 6M62 (I6/v6.33 lib 6/12N) SD

Red Room
There are exits to the north and west., and a door to the south.

You can see the wooden door here.

>s
(first opening the wooden door)

Orange Room.
There are exits to the east and south, and a door to the north.

You can see the wooden door here.

>w
Orange Room.
There are exits to the east and south.

>l
Orange Room.
There are exits to the east and south.

>look at wall
You see nothing special about the wall.

>look in wall
You find nothing of interest.

>open wall
It isn't something you can open.

>e
Violet Room
You can see a wooden door and Mr Fruit (on which is a pear) here.

>look at wall
You can't see any such thing.

>w
Orange Room.

* * *

>w
Orange Room.
There are exits to the east and south.

>look at wall
In the wall is an orange.

>look in wall
The wall is empty.

* * *

>take orange
Taken.

>i
You are carrying:
  an orange

>look at wall
The wall is empty.

>look at room
You can't see any such thing.

* * *

>s
(first opening the wooden door)

Orange Room.
There are exits to the east and south, and a door to the north.

You can see the wooden door here.

>s
Grey Room
There are exits to the north, south, and to the west a void.

There is a void to the west of this room, across which you can see a Green Room.

>s
Brown Room
There are exits to the north and east.

You can see a watermelon and a cherry here.

>take melon
The melon is extremely heavy!

>i
You are carrying:
  a watermelon

>s
You can't go that way.

>e
White Room
There is an exit to the west.

Here is a wacky banana car, powered by unknown technology. It has a steering column and a gas (?) pedal.

* * *

>get in car
You get into the the banana car.

"Banana banana!"

>w
Brown Room (in the the banana car)
You can see a cherry here.

"Banana banana!"

>n
Grey Room (in the the banana car)
There is a void to the west of this room, across which you can see a Green Room.

"Banana banana!"

>n
Orange Room. (in the the banana car)
You can see the wooden door here.

"Banana banana!"

>n
Red Room (in the the banana car)
You can see the wooden door here.

"Banana banana!"

>w
Blue Room (in the the banana car)
There are exits to the north and east.

You can see Mr Fruit here.

Mr Fruit says "That is one fine banana car, my dude."

>look at mr fruit
Mr Fruit is holding a jar of grapes

"Banana banana!"

>ask mr fruit for jar
Mr Fruit smiles and hands you the jar of grapes.

"Banana banana!"

>look at mr fruit
Mr Fruit is smiling, having seen something real cool drive past.

"Banana banana!"

* * *

Playground
An Interactive Fiction by Chris McLean-Wheeler and Jonathan Wheeler
Release 1 / Serial number 171114 / Inform 7 build 6M62 (I6/v6.33 lib 6/12N) SD

Red Room
There are exits to the north and west., and a door to the south.

You can see the wooden door here.

>n
Green Room
There are exits to the west and south.

In this room is a medium-sized cardboard box.

>w
Yellow Room
There are exits to the east and south.

>s
You can't go that way.

>look at mr fruit
Mr Fruit is holding a jar of grapes

>take grapes
Mr Fruit pulls it out of your reach, wags a finger at you, and says "Rude!"

>ask for grapes
You can't see any such thing.

>ask for jar
You can't see any such thing.

>ask mr fruit for jar
Mr Fruit smiles and hands you the jar of grapes.

* * *

>ask mr fruit for grapes
Mr Fruit extends his empty palms to you and shrugs.

>take grapes
Mr Fruit pulls it out of your reach, wags a finger at you, and says "Rude!"

>n
Green Room
In this room is a medium-sized cardboard box.

>drop all
(the jar)
Dropped.

>i
You are carrying nothing.

>look at jar
In the jar are some grapes.

>s
Blue Room
You can see Mr Fruit here.

I beg your pardon?

>e
Red Room
You can see the wooden door here.

>s
(first opening the wooden door)

Orange Room.
There are exits to the east and south, and a door to the north.

You can see the wooden door here.

>w
You can't go that way.

* * *

>s
Grey Room
There are exits to the north, south, and to the west a void.

There is a void to the west of this room, across which you can see a Green Room.

>e
You can't go that way.

>s
Brown Room
There are exits to the north and east.

You can see a watermelon and a cherry here.

* * *

>take cherry
The cherry is light!

>n
Grey Room
There is a void to the west of this room, across which you can see a Green Room.

>n
Orange Room.
You can see the wooden door here.

* * *

>e
Pink Room
There is an exit to the west.

You can see a tiny room here.

>take tiny room
Taken.

>w
Black Room

* * *

>w
Orange Room.
You can see the wooden door here.

>s
Grey Room
There is a void to the west of this room, across which you can see a Green Room.

>put room in void
The miniature room is tugged into the void by an unseen force. As it enters the void, it expands until it is normal room size, with entrances that perfectly align with the rooms on either side.

* * *

>e
Magenta Room

>e
Grey Room

>n
Orange Room.
You can see the wooden door here.

>e
Violet Room
You can see Mr Fruit (on which is a pear) here.

>n
You can't go that way.

>w
Orange Room.
You can see the wooden door here.

>n
Red Room
You can see the wooden door here.

>w
Blue Room
You can see Mr Fruit here.

>n
Green Room
In this room is a medium-sized cardboard box.

You can also see a jar (in which are some grapes) here.

>tape box
Now the box should withstand the weight of other objects inside it.

>take box
You're carrying too many things already.

>put tape in box
You put the roll of scotch tape into the box.

* * *

>i
You are carrying:
  a box
    a roll of scotch tape
    an apple
  a cherry

>put cherry in box
You put the cherry into the box.

>s
Blue Room
You can see Mr Fruit here.

>n
Green Room
You can see a jar (in which are some grapes) here.

>take jar
Mr Fruit pulls it out of your reach, wags a finger at you, and says "Rude!"

* * *

>s
You can't go that way.

>e
Green Room
In this room is a medium-sized cardboard box.

>s
Red Room
You can see the wooden door here.

>w
Blue Room
There are exits to the north and east.

You can see Mr Fruit here.

>e
Red Room
You can see the wooden door here.

* * *

>s
(first opening the wooden door)

Orange Room.
There are exits to the east and south, and a door to the north.

You can see the wooden door here.

>w
Violet Room
There are exits to the south and east.

You can see Mr Fruit (on which is a pear) here.

>s
Grey Room
There are exits to the north, south, and to the west a void.

There is a void to the west of this room, across which you can see a Green Room.

* * *

>s
Brown Room
There are exits to the north and east.

You can see a watermelon and a cherry here.

>n
Grey Room
There is a void to the west of this room, across which you can see a Green Room.

>n
Violet Room
You can see Mr Fruit (on which is a pear) here.

>e
Orange Room.
You can see the wooden door here.

>s
Darkness
It is pitch dark, and you can't see a thing.

>n
Orange Room.
You can see the wooden door here.

>w
Violet Room
You can see Mr Fruit (on which is a pear) here.

>s
Grey Room
There is a void to the west of this room, across which you can see a Green Room.

>w
You cannot traverse the void.

* * *

Playground
An Interactive Fiction by Chris McLean-Wheeler and Jonathan Wheeler
Release 1 / Serial number 171114 / Inform 7 build 6M62 (I6/v6.33 lib 6/12N) SD

Red Room
There are exits to the north and west., and a door to the south.

You can see the wooden door here.

>go through the door
(first opening the wooden door)

Orange Room.
There are exits to the east and south, and a door to the north.

You can see the wooden door here.

>go through the door
Red Room
You can see the wooden door here.

>go through the door
Orange Room.
You can see the wooden door here.

>go east
You can't go that way.

>goeast
That's not a verb I recognise.

>go east
You can't go that way.

>go south
Darkness
It is pitch dark, and you can't see a thing.

>keep going
That's not a verb I recognise.

>continue
That's not a verb I recognise.

>walk
You'll have to say which compass direction to go in.

>go south
You can't go that way.

>go north
Orange Room.
You can see the wooden door here.

>go through the door
Red Room
You can see the wooden door here.

I beg your pardon?

>l
Red Room
There are exits to the north and west., and a door to the south.

You can see the wooden door here.

>go north
Green Room
There are exits to the west and south.

In this room is a medium-sized cardboard box.

>open box
It isn't something you can open.

>look in box
In the box is an apple.

>take apple
Taken.

* * *

>take cardboard box
You can't see any such thing.

>go west
Yellow Room
There are exits to the east and south.

>go east
Green Room

>eat apple
You eat the apple. Not bad.

>l
Green Room
There are exits to the west and south.

>l
Green Room
There are exits to the west and south.

>w
Yellow Room

>l
Yellow Room
There are exits to the east and south.

>s
Blue Room
There are exits to the north and east.

You can see Mr Fruit here.

>look at mr fruit
Mr Fruit is holding a jar of grapes

>l
Blue Room
There are exits to the north and east.

You can see Mr Fruit here.

>talk to mr fruit
That's not a verb I recognise.

>ask mr fruit about life
There is no reply.

>take jar
Mr Fruit pulls it out of your reach, wags a finger at you, and says "Rude!"

>apologize
That's not a verb I recognise.

>ask for jar
You can't see any such thing.

* * *

>ask mr fruit for grapes
Mr Fruit extends his empty palms to you and shrugs.

>i
You are carrying:
  a jar
    some grapes
  a box

>n
Yellow Room

>restart
Are you sure you want to restart?

>y
Playground
An Interactive Fiction by Chris McLean-Wheeler and Jonathan Wheeler
Release 1 / Serial number 171114 / Inform 7 build 6M62 (I6/v6.33 lib 6/12N) SD

Red Room
There are exits to the north and west., and a door to the south.

You can see the wooden door here.

>w
Blue Room
There are exits to the north and east.

You can see Mr Fruit here.

>n
Yellow Room
There are exits to the east and south.

>e
Green Room
There are exits to the west and south.

In this room is a medium-sized cardboard box.

>take box
The box's bottom gives, and its contents spill onto the ground.

>l
Green Room
There are exits to the west and south.

You can see an apple here.

>i
You are carrying:
  a box

>restart
Are you sure you want to restart?

* * *

>y
Playground
An Interactive Fiction by Chris McLean-Wheeler and Jonathan Wheeler
Release 1 / Serial number 171114 / Inform 7 build 6M62 (I6/v6.33 lib 6/12N) SD

Red Room
There are exits to the north and west., and a door to the south.

You can see the wooden door here.

>n
Green Room
There are exits to the west and south.

In this room is a medium-sized cardboard box.

>take apple
Taken.

* * *

>s
Red Room
You can see the wooden door here.

>s
(first opening the wooden door)

Orange Room.
There are exits to the east and south, and a door to the north.

You can see the wooden door here.

* * *

>s
Brown Room
There are exits to the north and east.

You can see a watermelon and a cherry here.

>e
White Room
There is an exit to the west.

Here is a wacky banana car, powered by unknown technology. It has a steering column and a gas (?) pedal.

>get in banana car
You can't see any such thing.

>get in car
You get into the the banana car.

"Banana banana!"

>w
Brown Room (in the the banana car)
You can see a watermelon and a cherry here.

"Banana banana!"

>n
Grey Room (in the the banana car)
There is a void to the west of this room, across which you can see a Green Room.

"Banana banana!"

>n
Violet Room (in the the banana car)
You can see Mr Fruit (on which is a pear) here.

"Banana banana!"

>e
Orange Room. (in the the banana car)
You can see the wooden door here.

"Banana banana!"

>n
Red Room (in the the banana car)
You can see the wooden door here.

"Banana banana!"

>get out
You get out of the the banana car.

Red Room
Here is a wacky banana car, powered by unknown technology. It has a steering column and a gas (?) pedal.

You can also see the wooden door here.

>w
Blue Room
There are exits to the north and east.

You can see Mr Fruit here.

>ask mr fruit for jar
Mr Fruit says "Oh my, you've got your hands full, I see."

>i
You are carrying:
  a box
  an apple

>drop all
box: Dropped.
apple: Dropped.

>ask mr fruit for jar
Mr Fruit smiles and hands you the jar of grapes.

>look at mr fruit
Mr Fruit is standing here, wishing he could see something cool drive past

>e
Red Room
Here is a wacky banana car, powered by unknown technology. It has a steering column and a gas (?) pedal.

You can also see the wooden door here.

>get in car
You get into the the banana car.

"Banana banana!"

>w
Blue Room (in the the banana car)
You can see an apple, a box (empty) and Mr Fruit here.

Mr Fruit says "That is one fine banana car, my dude."
"Banana banana!"

>look at mr fruit
Mr Fruit is smiling, having seen something real cool drive past.

"Banana banana!"

>n
Yellow Room (in the the banana car)
There are exits to the east and south.

As you enter this room, the banana car is overwhelmed by the yellowness of its walls and floor. You are thrown from the car, and before your very eyes the car begins to transform into something else...something greater.

Yellow Room
There are exits to the east and south.

You can see a the banana car (empty) here.

>l
Yellow Room
There are exits to the east and south.

You can see a banana here.

>take banana
Taken.

>s
Blue Room
You can see an apple, a box (empty) and Mr Fruit here.

>e
Red Room
You can see the wooden door here.

>s
Orange Room.
You can see the wooden door here.

>look at wall
In the wall is an orange.

>take orange
You're carrying too many things already.

>i
You are carrying:
  a banana
  a jar
    some grapes

>drop all
banana: Dropped.
jar: Dropped.

>l
Orange Room.
There are exits to the east and south, and a door to the north.

You can see a jar (in which are some grapes), a banana and the wooden door here.

>s
Darkness
It is pitch dark, and you can't see a thing.

>n
Orange Room.
You can see a jar (in which are some grapes), a banana and the wooden door here.

>w
Violet Room
You can see Mr Fruit (on which is a pear) here.

* * *

>s
Grey Room
There is a void to the west of this room, across which you can see a Green Room.

>s
Brown Room
You can see a watermelon and a cherry here.

>take melon
The melon is extremely heavy!

* * *

>i
You are carrying:
  a watermelon

>take cherry
The cherry is light!

* * *

>n
Violet Room
You can see Mr Fruit (on which is a pear) here.

>e
Orange Room.
You can see a jar (in which are some grapes), a banana and the wooden door here.

>s
Black Room
You now see that the this room wasn't actually dark, but simply so black that you couldn't see the exits. These are to the north and east.

* * *

>e
Pink Room
There is an exit to the west.

You can see a tiny room here.

>drop all
cherry: Dropped.
watermelon: Dropped.

>take room
Taken.

>w
Darkness

>n
Orange Room.
You can see a jar (in which are some grapes), a banana and the wooden door here.

* * *

>w
You cannot traverse the void.

>look at room
This strange cube appears to be a miniature version of the rooms you've been walking through. It is magenta, and has two doors on opposite sides.

>put room in the void
The miniature room is tugged into the void by an unseen force. As it enters the void, it expands until it is normal room size, with entrances that perfectly align with the rooms on either side.

>w
Magenta Room
There are exits to the west and east.

* * *

>e
Grey Room

>n
Violet Room
You can see Mr Fruit (on which is a pear) here.

* * *

>e
Orange Room.
You can see a jar (in which are some grapes), a banana and the wooden door here.

>n
Red Room
You can see the wooden door here.

>w
Blue Room
You can see an apple, a box (empty) and Mr Fruit here.

>tape box
Now the box should withstand the weight of other objects inside it.

>take apple
Taken.

>put apple in box
You put the apple into the box.

>put tape in box
You put the roll of scotch tape into the box.

* * *

>i
You are carrying:
  a box
    a roll of scotch tape
    an apple

>RESTART
Are you sure you want to restart?

>Y
Playground
An Interactive Fiction by Chris McLean-Wheeler and Jonathan Wheeler
Release 1 / Serial number 171114 / Inform 7 build 6M62 (I6/v6.33 lib 6/12N) SD

Red Room
There are exits to the north and west., and a door to the south.

You can see the wooden door here.

>ask mr fruit for jar
You can't see any such thing.

>n
Green Room
There are exits to the west and south.

In this room is a medium-sized cardboard box.

>ask mr fruit for grapes
You can't see any such thing.

>s
Red Room
You can see the wooden door here.

* * *

>w
Blue Room
There are exits to the north and east.

You can see Mr Fruit here.

>ask mr fruit for jar
Mr Fruit smiles and hands you the jar of grapes.

* * *

Playground
An Interactive Fiction by Chris McLean-Wheeler and Jonathan Wheeler
Release 1 / Serial number 171114 / Inform 7 build 6M62 (I6/v6.33 lib 6/12N) SD

Red Room
There are exits to the north and west., and a door to the south.

You can see the wooden door here.

>ask mr fruit for jar
You can't see any such thing.

>w
Blue Room
There are exits to the north and east.

You can see Mr Fruit here.